   FFFFF     
  FFFFFFFFFF 
  RRRSSSRS   
 RSRSSSSRSSS 
 RSRRSSSSRSSS
 RRSSSSSRRRR 
   SSSSSSSS  
  FFXFFFF    
 FFFXFFXFFF  
FFFFXXXXFFFF 
SSFXPXXPXFSS 
SSSXXXXXXSSS 
SSXXXXXXXXSS 
  XXX  XXX   
 RRR    RRR  
RRRR    RRRR 